###############
#S            #
# ### ####### #
#   #       # #
### # ##### # #
#   #   #   # #
# ### # # ### #
#     #   #  E#
###############
