#####################
#S   #     #   #    #
### ### ### # # #####
#   #   #   # #     #
# # ### # ### ### # #
# #   # #   #   # # #
# ### # ### ### # # #
#   # #   #   # #   #
### # ### # # # ### #
#   #     # #   #  E#
#####################
