###########
#S  #     #
### # ### #
#   # #   #
# ### # ###
#   # #   #
### # ### #
#   #   #E#
###########
