#########################
#S                      #
# # ### ##### # ####### #
# #   #     # # #     # #
# ### # ### # # # ### # #
#   # #   #         #   #
### # ### ######### ### #
#   #   #     #     #   #
# ##### # ### # ### # ###
#     # #   #   #  E#   #
#########################
