#########
#S   #  #
# ## # ##
#    #  #
### #####
#      E#
#########
